1111111111111111111111111111111
1P00100000000010001000000000001
1011111011111010101110101011101
10001000001C10001000101010001C1
1110101111101110111011101111111
1000000010100000001010001000101
1110111010111010111011101011101
1000100010000010100000100000001
1110111110111011111011111011101
1000001010100010100000100010001
1011111010111110101111101110111
10000010001C1C1000001C101010001
1010111011101011101110101011101
1C1C1C10001000001000101000001C1
1111101010111110101010101111111
1000100010001010001C10101010001
1010111111101011101110101011101
101000101010100C100000001000001
1010111010111011101111101011111
1C10100000001010101000001010001
1110101111101010101111111011101
1000001010000010000000000000001
1110111011111010101110111010101
100000001C100000100010100010101
1111101110111111111111101111101
1C10001C000C1000000000101010101
1010111110111110111011101010101
101010101010100010001C100010001
1010101010101011101110101110111
1000000000000000100C10000010CE1
1111111111111111111111111111111