1111111111111
10000000000C1
1110011111001
1p0011E100001
1111111111111